@xwxywxyxywwxyxwxyxx
y........BBBBBBBBBBw
x.......E..........x
w..................y
z..................z
x..................x
w...a.b.c.d........y
w...a.b.c.d........w
x...a.b.c.d........x
yS......c..........x
wS..cc..c..cc......y
yS....ccccc........x
xS......c..........x
xwyxwwxywwxyxxwxywxy