wwwwwwwwwwwwwwwwwwww
w..................w
w..w............w..w
w..w............w..w
w...w..........w...w
w...w...wwww...w...w
w....w..w..w..w....w
w....w..w..w..w....w
w.....w.w..w.w.....w
w......w....w......w
w..................w
w.....wwwwww.......w
w..................w
w..................w
wwwwwwwwwwwwwwwwwwww