@xwxywxyxywwxyxwxyxx
yb....x...b...x...bw
x..................x
w..................y
z...x...x...x...x..x
x.x...............Sx
w.....B...a...B....y
wE....b...a........z
x...B...B.a.B...B..x
y.x...............Sx
w.....x.......x....y
y..................x
xb..x...x.b.x...x.bx
xwyxwwxywwxyxxwxywxy